ABCDEFGHO
         
000009470
002030098
060002001
         
000000507
070000060
803000000
         
600100020
740060900
019400000